######### ###########
#         #   #     #
# ####### ### # ### #
#       #     #   # #
# ##### # ### ##### #
# #     # #   #     #
# ### ### # ### # # #
#   # #   #     # # #
### # # ######### # #
#   # # #   #     # #
# ### # # # ##### # #
# #   #   #   # # # #
# # ######### # # # #
# #     #   # #   # #
# # ##### # # ##### #
# #   #   # # #   # #
# ### # # ### ### # #
# #   # # #   #   # #
# # ### # # ### ### #
# #     # # #       #
########### #########
